  R	800    	   600
NO ./path_to_the_north_texture
WE ./path_to_the_west_texture

EA ./path_to_the_east_texture
SO  ./path_to_the_south_texture
   S ./path_to_the_sprite_texture
C      225,30,150
F      255,30,150

        1111111111111111111111111        1111111
        1000000000110000000000001        1000001
        1000000000000000022000001        1000001
        1000000000000000000000001        1111111
111111111011000001110000000000001
100000000011000001110111111111111
11110111111111011100000010001
11110111111111011101010010001
11000000110101011100000010001
10002000000W00001100000010001
10000000000000001101010010001
1000000111010101111101111000111
11110111 1110101 101111010001
11111111 1111111 111111111111


