  R	800    	   600
NO ./path_to_the_north_texture
WE ./path_to_the_west_texture

EA ./path_to_the_east_texture
SO  ./path_to_the_south_texture
   S ./path_to_the_sprite_texture
C      225,30,150
F      255,30,150

111111111111
100000000001
100000000001
101000N00001
100000000001
100000000001
111111111111

