  R	1600   	   900    
SO  ./textures/cub_texture_south.xpm    
NO			./textures/cub_texture_north.xpm   
WE ./textures/cub_texture_west.xpm    
EA ./textures/cub_texture_east.xpm    
   S ./sprites/sprite1.xpm    



F		./textures/jade.xpm			
C						255  ,   200			,  35    

11111111111111111111111111111 1111111
10000000001100000000000000001 1110001
10110000011100000020000010001 1000001
10010000000000200000000010001 1111111
10110000011100000200000010011
10000000001100000111011110001
11110111111111011100000010001
11110111111111011101010010001
11000000110101011100000010001
10002000000000001100000010001
10000000000000001101010010001
10000000000000001101010010N01
11000000110101011111011110001
11110111111101011111011110001
11111111111111111111111111111
10002000000000001100000010001
10000000000000001101010010001
11111111111111111111111111111
