  R	1600   	   900
NO ./textures/Texture_North.xpm
WE ./textures/Texture_West.xpm

EA ./textures/Texture_East.xpm
SO  ./textures/Texture_South.xpm
   S ./path_to_the_sprite_texture
C      225,30,150
F      255,30,150

11111111111111111111111111111
10000000001100000000000000001
10110000011100000020000010001
10010000000000200000000010001
10110000011100000200000010011
10000000001100000111011110001
11110111111111011100000010001
11110111111111011101010010001
11000000110101011100000010001
10002000000000001100000010001
10000000000000001101010010001
10000000000000001101010010N01
11000000110101011111011110001
11110111111101011111011110001
11111111111111111111111111111
10002000000000001100000010001
10000000000000001101010010001
11111111111111111111111111111

