  R	1920   	   1080
NO ./textures/Texture_North.xpm
WE ./textures/Texture_West.xpm

EA ./textures/Texture_East.xpm
SO  ./textures/Texture_South.xpm
   S ./path_to_the_sprite_texture
C      225,30,150
F      255,30,150

11111111111
10110000011
10010000001
10110000011
10000000001
11111111111
11111111111111111111111111111111111111111
10001000100010000000101000101000000000001
10111110101110101010101010101111101111101
10001000000000101010100010001000001000001
11101011111110111011101011101010111110111
10000000100000100000101010101010100000101
11101111111111111111101010101111111011101
10100000001000001000101010000000001000101
10101111101010111011111011111010101011101
10001000100010000000000010000010100010001
11111011111111111010111110101110111010111
10100000101010001010100010100010001000001
10101110101010101111101010101011101110111
10001010101000101000001000101000101010001
10111011101011111011111011101011101011101
10000000100000101000100010001000101000001
10111110111110101110101011101011111011101
10101000100000100000101000101000100010001
11101010101110111111111110111011111011101
10100010000010001010000000001000100010001
10101110111011111010111010101011101111111
10101000001010000000101010101000101000101
10101011101110111011101110101110101011101
10001010001010001010101000101000100010001
10111111101010111110101011111011101011101
10000010000000100000100000100010101010001
10101010101010111110111110111010101111101
1010101010101000N010000000001000101000001
11101010111011101011101011111111101111101
10101010100010001000101010000010101000001
10101111101010101010111110101110101111101
10001000101010101010101000101010000000001
11101110111111111010101011111011101110101
10000010001010100010000010000010000010101
10111110111010111110111111101110111111111
10001000001000000000000010000000000010001
11101110101011101111111011101110111011101
10000010100010101000001010000010100000001
10101111101110111110111010111011101110111
10100010000000000000001010100000100010001
11111111111111111111111111111111111111111

