  R	1920   	   1080
NO ./textures/cub_texture_north.xpm
WE ./textures/cub_texture_west.xpm

EA ./textures/cub_texture_east.xpm
SO  ./textures/cub_texture_south.xpm
   S ./sprites/sprite1.xpm
F     ./textures/jade.xpm
C      ./textures/crystal.xpm

11111111111
10110000011
10010000001
10010000001
10010002001
10010000001
1011000N011
10002000001
11111111111
